stepCheck	@RUNCHECK -i @INPUT -b @BARCODES -a @ADAPTER -t @TRIM -o @OUTDIR -r no -s stepCheck -j @JGEN	1
stepGetTotalReads	@RUNGETTOTALREADS -b @BARCODES -g 28 -p @SPAIRED -o @OUTDIR -u @USERNAME -j @JGEN	10
stepBackupS3	@RUNBACKUPS3 -b @BARCODES -g 28 -p @SPAIRED -o @OUTDIR -u @USERNAME -j @JGEN	10
stepFastQC	@PERL @RUNFASTQC -b @BARCODES -o @OUTDIR -p @FASTQCPROG -s stepFastQC -j @JGEN	1
stepMergeFastQC	@PERL @RUNFASTQCMERGE -o @OUTDIR	0
stepAdapters	@RUNADAPTER -d @SPAIRED -p @PREVIOUSADAPTER -o @OUTDIR -a @ADAPTER -c @MATICCMD -s stepAdapter -j @JGEN	1
stepQuality	@RUNQUALITY -d @SPAIRED -p @PREVIOUSQUALITY -o @OUTDIR -q @QUALITY -c @MATICCMD -s stepQuality -j @JGEN	1
stepTrim	@RUNTRIM -t @TRIM -d @TRIMPAIRED -p @PREVIOUSTRIM -o @OUTDIR -c @TRIMMERCMD -s stepTrim -j @JGEN	1
stepSeqMappingrrna	@RUNRECMAPPING -i @INPUT -a @AWKDIR -d @SPAIRED -m @SAMTOOLS -o @OUTDIR -b @PARAMrrna -c @BOWTIE2CMD -s stepSeqMappingrrna -r @ADVPARAMS -j @JMAPPING	1
stepSplit	@PERL @RUNSPLIT -o @OUTDIR -d @SPAIRED -p @PREVIOUSSPLIT -n none -se stepSplit -j @JGEN	5
stepRSEM	@RUNRSEM -c @RSEMCMD -r @RSEMREF -d @SPAIRED -pa @PARAMSRSEM -pr @PREVIOUSPIPE -o @OUTDIR -b @BOWTIEPATH -s stepRSEM -j @JRSEM	10
stepRSEMCountgenestpm	@RUNRSEMCOUNT -o @OUTDIR -t tpm -g genes -s stepRSEMCountgenestpm -j @JGEN	0
stepRSEMCountgenesexpected_count	@RUNRSEMCOUNT -o @OUTDIR -t expected_count -g genes -s stepRSEMCountgenesexpected_count -j @JGEN	0
stepRSEMCountisoformstpm	@RUNRSEMCOUNT -o @OUTDIR -t tpm -g isoforms -s stepRSEMCountisoformstpm -j @JGEN	0
stepRSEMCountisoformsexpected_count	@RUNRSEMCOUNT -o @OUTDIR -t expected_count -g isoforms -s stepRSEMCountisoformsexpected_count -j @JGEN	0
stepTophat2	@PERL @RUNTOPHAT2 -o @OUTDIR -g @GTF -d @SPAIRED -pa @PARAMSTOPHAT -pr @PREVIOUSPIPE -t @TOPHAT2CMD -b @BOWTIE2INDEX -sa @SAMTOOLS -se stepTophat2 -j @JTOPHAT	5
stepSeqMappingChip	@RUNRECMAPPING -i @INPUT -a @AWKDIR -d @SPAIRED -m @SAMTOOLS -o @OUTDIR -b @PARAMChip -c @BOWTIE2CMD -s stepSeqMappingChip -r @ADVPARAMS -j @JMAPPING	1
stepMergeChip	@PERL @RUNMERGECHIP -o @OUTDIR -d @SPAIRED -sa @SAMTOOLS -se stepMergeChip -j @JGEN	5
stepMACS	@RUNMACS -a @MACSCMD -i @CHIPINPUT -o @OUTDIR -s stepMacs -p @PREVIOUSPIPE -j @JMACS	10
stepAggregation	@RUNAGGREGATION -o @OUTDIR -a @ACT -b @BTOOLSGENCOV -c @INTOPDF -p @PREVIOUSPIPE -g @GENOMESIZE -r @REFACT -s stepAggregation -j @JAGG	10
stepCounts	@RUNCOUNTS -m @MAPNAMES -o @OUTDIR -g @GCOMMONDB -b @MAKEBED -c @BEDTOOLSCMD -s stepCounts -j @JGEN	1
stepMakeReport	@RUNMAKEREPORT -f @OUTFILE -o @OUTDIR -m @MAPNAMES -s stepMakeReport -j @JMAPPING	1
